0000000000000000000000000000000000000000000000
0000000000000000000000000000000000000000000000
0000000000000000000000000000000000000000000000
0000000000000000200000000000000000000000000000
0002002222222200000000000022000000000000002222
0000000000000000000000000000000000000000021111
2200000000000000022222200000022222000000211111
1122222222222222211111100000011111200022111111
1111111111111111111111100000011111120000000000
1111111111111111111111100000011111112000000000
1111111111111111111111100000011111111200000000
1111111111111111111111100000011111111200000000
1111111111111111111111100000011111111120000000