111111111111110000000000000000000000000000000000000000000000000000000000000000000000000000000000011111111111111111111111111111111111111111111111111111111111111111111111
111111111111110000000000000000000000000000000000000000000000000000000000000000000000000000000000011111111111111111111111111111111111111111111111111111111111111111111111
111111111111110000000000000000000000000000000000000000000000000000000000000000000000000000000000011111111111111111111111111111111111111111111111111111111111111111111111
111111111111110000000000000000000000000000000000000000000000000000000000000000000000000000000000011111111111111111111111111111111111111111111111111111111111111111111111
111111111111110000000000000000000000000000000000000000000000000000000000000000000000000000000000011111111111111111111111111111111111111111111111111111111111111111111111
111111111111110000000000000000000000000000000000000000000000000000000000000000000000000000000000011111111111111000000000000000000000000000000000000000000000000000000000
111111111111110000000000000000000000000000000000000000000000000000000000000000000000000000000000011111111111111000000000033000000000000000000000000000000000000000000000
111111111111110000000000000000000000000000000000000000000000000000000000000000000000000000000000011111111111111000200003111000000000000000000000000000000000000000000000
111111111111110000000000000000200000000000000000000000000000000000000000000000000000000000000000011111111111111000000000000000000000000000000000000000000000000000000000
111111111111110002002222222200000000000022000000000000002222000000000000000222000002000000000000011113111311111030000000000000000000000000000000000000000000000000000000
111111111111110000000000000000000000000000000000000000021111000000000000000000000000000000000000001311111113111013300000000000000000000000000000000000000000000000000000
111111111111112200000000000000022222200000022222000000211111000000000000200000000000000000000000000133333331111011133300000033000000000000000000000000000000000000000000
111111111111111122222222222222211111100000011111200000111111000000000000000000000000000000000022100111111111111000000000000000000000000000000000000000000000000000000000
111111111111111111111111111111111111100000011111120000000000000000000000002000000000000000200011100111111111111000000000000000000000000000000000000000000000000000000000
111111111111111111111111111111111111100000011111112000000000000000000000000000000000002000000211100000111111111000000000000000000003300000000000000000000000000000000000
111111111111111111111111111111111111100000011111111200000000000000002200000022000000000000000111100000000000000000000000000000000000000000000000000000000000000000000000
111111111111111111111111111111111111100000011111111100000000000000000000000000000020000000000111100000000000000000000000000333000000000000000000000000000000000000000000
111111111111111111111111111111111111100000011111111120000000000000000000002222222210000000000111111111111111111000003300000000000000000000000000000000000000000000000000